+..........................+++++++++++++++++#+++++++++++++..........+.........+.....................
.++++.....................++..............................++++++++++...........+....................
....+++..................+..++....................................++++++++++++++....................
......+.................+.....+..................................+..............+...................
.....++................+.......+.........++++++++++++++++........+...............+..................
....+.................+.........+...+++++................+.......+................+.................
.+++..................+..........+++......................+.....+.................+.................
+.....................+..........+.........................+...+..................+.................
+.....................+...........+.........................+.+....................+++++++..........
.+...............++++++..........+..........................++............................+.........
..+++++++++++++++................+........................++.+.............................+........
................................+.......................++....+.............................+.......
................................+.....................++.......+.............................++++...
................................+..................+++..........+++.............................+...
...............................+................+++................+++..........................+...
..............................+...............+++...................++..........................+...
.............................+................+.....................+++++........................+..
..................++++*++++++.................+..........................+..........................
................++............................+...........................+.........................
...............+..............................+............................+........................
..............+..............................+..............................+.......................
..............+..............................+..............................+.......................
.............+...............................+.............................+........................
.............+...............................+............................+.........................
..............+......................+++++++++++++*+++++++++..............+.........................
..............+................++++++........+..............++++++.......+..........................
...............+++++++++++*++++.............+.....................++....+...........................
............................................+.......................+++++...........................
...........................................+...........................++...........................
...........................................+..........................+..++.........................
..........................................+...........................+....++.......................
..........................................+..........................+.......++.....................
........................................++...........................+.........++...................
......................................++............................+............++.................
....................................++..............................+..............++...............
.................................+++...............................+.................+++............
............................+++++..................................+....................++..........
..........................++.......................................+......................+.........
....................#+++++........................................+.................................
..........................++........................................................................
............................+++++...................................................................
.................................+..................................................................
.................................+..................................................................
.................................++.................................................................
............++++++++++++++++++*++...................................................................
.........+++........................................................................................
.......++...........................................................................................
......++.................................................++++++++++++...............................
......+...........................................+++++++............+++++..........................
......++........................................++........................++++......................
........++++++++++++++++++++++++++++++++++++++++++++++........................+.....................
............................................++........+++++++++................++...................
...........................................+...................++++..............+..................
..........................................+........................+++............+.................
.........................................+............................+...........+.................
........................................+..............................++..........+................
........................................+................................+..........+...............
........................................+.................................+..........++.............
........................................++................................+............+............
..........................................*+.............................+..............+...........
............................................++.........................++................+..........
..............................................+++.................+++++...................+.........
.................................................+++++++++++++++++.........................+........
............................................................................................+.......
.............................................................................................+......
..............................................................................................+.....
...............................................................................................+....
................................................................................................+...
.................................................................................................+..
.................................................................................................+..
.................................................................................................+..
.................................................................................................+..
..................................................................................................+.
.........................................+......................................................+++.
.........................................+...................................................+++....
........................................+.................................................+++.......
.......................................+...............................................+++..........
......................................+............................................++++.............
....................................++........................................+++++.................
...........++.....................++...................................+++++++......................
.............+++++..............++...........................++++++++++.............................
..................++++++++...+++...............++++++++++++++.......................................
..........................+#+++++++++++++++++++.....................................................
......+++...............++++........................................................................
.........++..........*++............................................................................
...........+....+++++...............................................................................
...........+++++....................................................................................
...++++++++.....+++++...............................................................................
....................++++............................................................................
.......................+++++........................................................................
............................++++++++................................................................
....................................++++++++........................................................
............................................++++++++++++............................................
............................................+..........++++++++++++++++++++#+++.....................
............................................+.................................++++++++++*+++........
...........................................+........................................................
...........................................+........................................................
...........................................+........................................................
...........................................+........................................................
...........................................+........................................................
